11111111
100001E1
100000C1
1P000C11
11111111
