1111111111
1100001C11
1100001E11
11P0000C11
1111111111
1111111111