1111111111111
10010000X0001
100P0000
10EX0000X0001
10X00C0000001
1111111111111
