11111111
100001E1
10000011
1P000C11
11111111
