11111111
100001C1
100000X1
1P000E11
11111111
